W       WWWWWWWWWWWWWWWWWWWWWWWWWWWWWWWW
WB       WWWW   WW  WW   WW    WWWWWWWWW
W   S      W     W       W      WWWWWWWW
WWWW D           W       W        W   WW
WWWWWWr  E Dr                          W
WW  WWWWWWWW   I        I            F W
W    WWWWWW   WWTW     WWWr   E r  s   W
W            DWWWWW   WWWWWW!!WW    WWWW
WI  D        WWWWWWW_WWWWWWWWWW    WWWWW
WWTTW D    WWWWWWWWW WWWWWW  WW__WWWWWWW
WWWWWWW D       WW     WW     W       WW
WW    W_WW                         I   W
WW      WWWWr  E   r   D       D IWW  IW
WWI TWWWWWWWWWWWWWWaaaWWWr DE rWWWWW  WW
WWWWWWWWWWWWWWWWWWWAAAWWWWWWWWWWWWWW!WWW
