WWWW            WWW          WWW      WW
WW              WW            WW      WW
W                W            W       WW
W                W            W      IWW
W!IIWW  WW            W   W          WWW
WWWWWWAAWWW           WTTTW  rE    rWWWW
WWWWWWWWWWWWWWW  WWWWWWWWWWWW WWWWWWWWWW
WWWWWWWWWWWWWW   WWWWWWWW         WWWWWW
WWWW            WWWWWWWW             WWW
WWW             WWWWW                 WW
WW    r   E r  WWWWW           D       W
W      WWWWW  DWWWW         W WW       W
WB            WWWW       DWWW!WWW    F W
W   SWWWWTTWWWWWWWWI  TTWWWWWWWWWW s   W
WWWWWWWWWWWWWWWWWWWWWWWWWWWWWWWWWWWWWWWW
