WWWWWWWWWWWWWWWWWWWWWWWWWWWWWWWWWWWWWWWW
WW WW        WWWWWWWWWW WWWW W     WWWWW
W  W     F  WWWWW W  W   WW  W     WWWWW
W      s   WWWW      W    W       IWWWWW
W    D  WWWWWW            W     D WWWWWW
W   WWWWWWWW     r  DE  r       WTWWWWWW
W      W   W     WWWWWWWW      WWWWWWWWW
WW                W   WW       WWWWW WWW
WW            I       W      TWWW  W  WW
WWWTTWr  ED rWWW   D       DWWWW   W  WW
WWWWWWWWWWWWWWW    WrE  r  WWW        WW
WWWWWWWWWWWWWW    WWWWWW              WW
WWWWWWWW         WWWWWWW         D   IWW
WWWW WW       D WWWWWWWWW        WTTTWWW
WW   W        WTWWWWWWWWW!W     WWWWWWWW
WWI     DWTTWWWWWWWWW WWWWW    WWWWWWWWW
WWWI    WWWWWWWWWWW W  WWWWWW       WWWW
WWWWTTWWWWWWWW WWWW W  WWWWWWW D     WWW
WWWWWWWWW WW   W       W   WWWWWW     WW
WWWWWWWWW  W           W        WW    WW
WWWWWWWW   W      v            rE   rWWW
WWWWW WW     D    W           WWWWWWWWWW
WW WW W      W   WW        IWWWWWWWWWWWW
WW W  W      WI   WWr  E rWWWWWW      WW
WW          WWW   WWW____WWWWW       VWW
W           WWaaaaWWW    DD        IWWWW
W       D W!WWAAAAWWWaaaWWW        WWWWW
WB  S   W!WWWWAAAAAAAAAAWWWr  E rW WWWWW
W   WWWWWWWWWWWWWWWWWAAAWWWWWWWWWWTWWWWW
WWWWWWWWWWWWWWWWWWWWWWAAWWWWWWWWWWWWWWWW
