W        WWWWWWWWWWW
W           WWW   WW
WB  S D I vWWW   WWW
WWWW  WWWWWWW     WW
WWWW  WWW WW     F W
WWW D W    W   s   W
WWW W WIDDI  D WWWWW
WWW W!WW_WW  WWWWWWW
W W WWWW    W     IW
W I  WWr  E D r  W_W
W WW WWW!WWWWW  WWTW
W  WD WWW       WWWW
W  WW  W      WaWWWW
W VWWr  E  DrWWAAAAA
W!WWWWWWW!!WWWWAAAAA
