W     WWW                     WWWWWWWWWW
WB     WW       r  E  I  r    WWW WWWWWW
W   S  W  r  E  rWWWWWWWW      WW  WWWWW
WWW    W   WWWWWWWWWWWWWWWs F DW   W  WW
WWWWWWD v      WWW WWWWWWWW   WW       W
WWWWWWWWW DD    W   W    WWWWWW  r IE rW
WWWWWWWWWWWW  I   r D  E DD r     WWWW_W
WWWW   WWWWWWWW    WWWWWWWWWW    WWWWW W
WWW   WWWW WWWW           WW    WWWW W W
WWW  WW    WW WW           W   DW      W
WW     ID  W      D   I       WWW      W
WV    WWW         WW  W  W   WWW    I  W
WWW  WW   r  E  rWWW  WaaWW         W  W
Wr   E D  rWWWWWWWWW!!WAAWWW D  DD!!WITW
WWWWWWWWWWWWWWWWWWWWWWWAAWWWWWaaWWWWWWWW
