WWWWWWWWWWWWWWWWWWWW
W                  W
W       WWW        W
W         W        W
W         W        W
W         W        W
W         W        W
WTTTT          IIIIW
WWWWWWWWWWWWWWWWWWWW
W                  W
W                  W
W                  W
WB               F W
W  S            s  W
WWWWWWWWWWWWWWWWWWWW
