WWWWWWWWWWWWWWWWWWWW
W                  W
W       WWW        W
W       W W        W
W       WWW        W
W         W        W
W       WWW        W
WTTTT          IIIIW
WWWWWWWWWWWWWWWWWWWW
W                  W
W                  W
W                  W
WB               F W
W  S  IIIIIIII  s  W
WWWWWWWWWWWWWWWWWWWW
