WWWWWWWWWWWWWWWWWWWW                    
W                  W                    
W       WWW        W                    
W       W          W                    
W       WWW        W                    
W         W        W                    
W       WWW        W                    
WTTTT          IIIIW                    
WWWWWWWWWWWWWWWWWWWWWWWWWWWWWWWWWWWWWWWW
W                                      W
W                                      W
W                                      W
WB                                   F W
W   S                              s   W
WWWWWWW_________WWWWWWWWWWWWWWWWWWWWWWWW
      W        WW                       
      W        W                        
      W       WW                        
      W       W                         
      W      WW                         
      W      W                          
      W     WW                          
      W     W                           
      W    WW                           
      W    W                            
      W   WW                            
      W   W                             
      W  WW                             
      W  W                              
      WWWW                              
