WWWWWWWWWWWWWWWWWWWWWWWWWWWWWWWWWWWWWWWW
WW     WW      WWWWWWWW  WW  W  WW WWWWW
WB                       W      W    WWW
W   S       D            W            WW
WWWW     DWWWWr E r DI       T       F W
WWWWWD   WWWWWWWWW!!WWW     WWWW   s   W
WWWWWW   WWW WWWWWWWWWWI   WWWWWW  WWWWW
WWWWWW  DWW    WWWWWWWWWW  WWWWW   WW  W
WWWWWW  WW I    WWWWWWWW   W W W  WW   W
W   WW  WWWWTT  WWWWWWW      W         W
WI       WWWWW  W WW            DWW   IW
WW       W WWWD      r  E  r    WWWW__WW
WWr E r      WW       WWWWW D  WWWWWTTWW
WWWWWWr DD E   D   rWWWWWWWWW!WWWWWWWWWW
WWWWWWWWWWWWWWWWaaWWWWWWWWWWWWWWWWWWWWWW
