WWWW      WWWWWWWWWWW        WWW      WW
WWW        WWW  WW  W         WW      WW
W W         WW   W            W       WW
W    D      W    W            W      IWW
WTIIWWaaWW            W   W          WWW
WWWWWWAAWWW v         WTTTW  rE  D rWWWW
WWWWWWWWWWWWWWW  WWWWWWWWWWWW WWWWWWWWWW
WWWWWWWWW WWWW   WWWWWWWWWW      WWWWWWW
WWWWWW       W  WWWWWWWWWW        WW WWW
WWW W           WWWWW  WW         W   WW
WW  W r   E r  WWWWW    W     D   W    W
W      WWWWW  DWWW          W WW       W
WB      D  D  WWWWV      DWWW!WWW    F W
W   SWWWWTTWWWWWWWWI  TTWWWWWWWWWW s   W
WWWWWWWWWWWWWWWWWWWWWWWWWWWWWWWWWWWWWWWW
