WWWW            WWW          WWW      WW
WW              WW            WW      WW
W                W            W       WW
W    D           W            W      IWW
W!IIWWaaWW            W   W          WWW
WWWWWWAAWWW v         WTTTW  rE  D rWWWW
WWWWWWWWWWWWWWW  WWWWWWWWWWWW WWWWWWWWWW
WWWWWWWWWWWWWW   WWWWWWWW         WWWWWW
WWWW            WWWWWWWW             WWW
WWW             WWWWW                 WW
WW    r   E r  WWWWW          D        W
W      WWWWW  DWWW          W WW       W
WB            WWWWV       WWW!WWW    F W
W   SWWWWTTWWWWWWWWI  TTWWWWWWWWWW s   W
WWWWWWWWWWWWWWWWWWWWWWWWWWWWWWWWWWWWWWWW
