WWWW               WWWWWWWWWWWWWWWWWWWWW
WWW                 WWWWWWWWWWWWW WWWWWW
WWWIr E  r      DI   WWWWWWWW     W   WW
WWWWWTWWW     WTWW___WWWWW W          WW
WWWWWWWW    WWWWWW___WWW         D   IWW
WWWW      WWWWWWWW___WW       WTTW IIWWW
WWW     DWWW WWW            WTWWWWTWWWWW
WW     WWWW       r    E DrWWWWWWWWWWWWW
WWI     WW       D WWTWWWWWWWWWWWWWWWWWW
WWWWWW        WWWWWWWWWWWWWWWWWWWWWWWWWW
WWWWW        WWWWWWWWWWW     WW WWWWWWWW
WWWWWWW    D     WWW                WWWW
WWWWWWWWTTTWW      W                W  W
WWWWWWWWWWWWWW       r     E     r     W
WW WW            D I  WTWWTWWWTWW    F W
W  W  r    E  rWWWWW__WWWWWWWWWWWWWs   W
W      WWTWWWWWWWWWW  WWWWWWWWWWWWWWWWWW
W     WWWWWW WWWW  W   WWWWWWWWWWWWWWWWW
W   WWWWWW   W  W       WWWWWWWWWWWWWWWW
WW                      W  WW WWWWWWWWWW
WWWr   E      r            W   W WWWWWWW
WWWWWWWWWWTWWW__WWTTWW            WW  WW
WWWWWWWWWWWWWW  WWWWWWTTW         W    W
WWWWWWWWWWW WW  WWWWWWWWWTW  D         W
WWW WWWWW    W  WW WWWWWWWWWWWTWW      W
WW  W WW   D W  W   WWW WW  WWWWWWW   IW
W         WW        W                 WW
W B      WWW                         WWW
WW   S WWWWWWWr   E  D  rWTTWr E  rWWWWW
WWWWWWWWWWWWWWWWWWWWWWWWWWWWWWWWWWWWWWWW
