WWWWWWWWWWWWWWWWWWWW
W                  W
W       W WWW      W
W      WW W W      W
W       W W W      W
W       W W W      W
W       W WWW      W
WTTTT          IIIIW
WWWWWWWWWWWWWWWWWWWW
W                  W
W                  W
W                  W
WB               F W
W  S            s  W
WWWWWWWWWWWWWWWWWWWW
