WWWWWWWWWWWWWWWWWWWWWWWWWWWWWWWWWWWWWWWW
WWWWWWWWWWW              WWWWWW     WWWW
WWWWWWWWW r     E   Dr   WWWWW       IWW
WWWWWWWW   WW__WWWWWW    WW  W      IWWW
WWWWWWW   WW   WWWWWWW  WWW        WWWWW
WWWWWW     D   WW      WWW      TW_WWWWW
WWWWWII    WW  W      WWW    WWWWW WWWWW
WWWWWWWWW_WWW  W     WWW    WWWW   WWWWW
WWWWWWWWW WWWT     W!WW    WWW      W  W
WWWWW       WWWWW  WWW    WWWW      W  W
WWWW                      WWWWI        W
WWW           D  W     I WWWWWWI       W
WWW B       WWWWWWWWWWWW    WWWWTTW   WW
WWWW  S    WWWWWWWWWWWWWW D   WWWWW   WW
WWWWWW  WWWWWWWWWWWWWWWWWWW          WWW
WWWWWWWWWWWWWWWW     WWWWWWW          WW
WWWWWWWWWWWWW           WWWWW       W!WW
WWWWWWWWWWWW              WWWW      WWWW
WWW   WWWW II TTTT D       WWWW    WWWWW
W      WW  WWWWWWWWWW     r    E  rWWWWW
WI      W WWWWWWWWWWWWW   WWWWWWWWWWWWWW
WWI     W    WWWW        WWWWWWWWWWWWWWW
WWW           W        WWWW    WWWW   WW
WWWW                 WWWW        WW   WW
WWWWW              WWWW            D IWW
WWWWWr  E  D  r    WWW             W!WWW
WWWWWWWWWWWWWWaaWW                WWWWWW
WWWWWWWWWWWWWWAAWWWWWWW        s F WWWWW
WWWWWWWWWWWWWWAAWWWWWWWWrD E  rW   WWWWW
WWWWWWWWWWWWWWAAWWWWWWWWWWWWWWWWWWWWWWWW
