W           WWWWWWWW
WB    r  EDr      IW
W   S  WWWW   D  IWW
WWWW   D   v WW_WWWW
WWWWW  WTTWWWWW WWWW
W      WWWW   W WWWW
WV    WWWWID    W WW
WWTW  WW WWWW      W
WWWWW W         DIIW
WW r D   ED rWTTWWWW
W   WWWWWWWWWWWWWWWW
W  WWW            WW
W      r  D E  r F W
Wr  ED rWWWWWWWs   W
WWWWWWWWWWWWWWWWWWWW
