WWWWWWWWWWWWWWWWWWWW
WB      WW        IW
W   S   W      D  WW
WWWWW     r E rWTWWW
WWWWWWTD   WWWWWWWWW
WW   WWW  WWWWWWWWWW
W   IWWW vWWWWWW  WW
W  TWWWW WWWW      W
W WWWW         I   W
W D           WW   W
WWWW        WWWWW DW
WWWW_W    W!WF  W WW
WWWaaWTTW_WWW   s WW
WWWAAWWWWVWWWWWWWWWW
WWWAAWWWWWWWWWWWWWWW
