WWWWWWWWWWWWWWWWWWWW
WB      WW        IW
W   S   W         WW
WWWWW     r E rWTWWW
WWWWWWT    WWWWWWWWW
WW   WWW  WWWWWWWWWW
W   IWWW  WWWWWW  WW
W  TWWWW WWWW      W
W WWWW         I   W
W             WW   W
WWWW        WWWWW  W
WWWWbW    W!WF  W WW
WWW  WTTWWWWW   s WW
WWWAAWWWWWWWWWWWWWWW
WWWAAWWWWWWWWWWWWWWW
